##...##...##..#
#..##.....###.#
#.###..#####..#
#.#...###....##
#...#####..####
..###..........
#.....#########
####......#####
###...##...####
#...#####...###
..###...##..###
...............
#####....######
.......########
######.########
